111111111111111111111111111111111111111111111111111
100000000000000000000000000000000000000000000000001
100000000000000000000000000000000000000000000000001
1P0000000000000000000000000000000000000000000000001
100111111000000000000000000000000000000000000000001
100111111111111111111111111111111111111111111111111
1CCCCCCCCCCCCCCCCCCCCCCCCCCCCCCCCCCCCCCCCCCCCCCCCC1
10000000000000000000000000000000000000000000000E001
111111111111111111111111111111111111111111111111111