11111111111111111
1CCCCCCCCCCCCCCC1
1C1C111C111C111C1
1C1CCC1C001CCC1C1
1P1C111C111CCE1C1
1C1CCC1C001CCC1C1
1C1C111C111CCC1C1
1CCCCCCCCCCCCCCC1
11111111111111111
