11111111111111111111
1000000000110110000
11111111111100000001
111111111111100
11111111111111111111