1111111111111
10P10C000E001
1C01000000001
111000000E001
1111111111111
