1111111111111
11P10C000E001
11010Z0000001
11100C0000001
1111111111111
