1111111111111
1P1C0C1C001E1
1010101010101
1C0C1C0C1C0C1
1111111111111


