1111110111111
1000000000001
1000000000001
0100000000001
1111111111111
