11111111111111111111111
1P00C00C000000000000001
11100100000111000101111
10000100010001000100001
100C0111110101111111101
10C00000010001000100001
11110001110111000100001
100000000000000000E0001
11111111111111111111111
