11111111111111111111111
1P00C00C000000000000001
10000101110111011100001
10000100010001000100001
100C0101110111000100001
10C00100010001000100001
10000101110111000100001
100000000000000000E0001
11111111111111111111111
